111111111111111
1C0100000000101
1001C1110000001
1P0110EC1111101
100000000000001
101100001000001
100010001000001
111111111111111