1111111111111111111111111111
1E0000000000000C00000C0000C1
1010010100100000101001000001
1010010010101010001001000001
1P0000000C00C000000000000001
1111111111111111111111111111